the	ちなまりうゆひほち	チナマリウユヒホチ
of	⊍かゆ⊆す	⍕カユ⌽ス
to	⊀りのな▣みくしな	⌶リノナ◈ミクシナ
and	んめ⊅ここ	ンメ⌼ココ
a	いわのへ	イワノヘ
in	ほ⊄し	ホ⌻シ
is	も⊉とはる	モ⍀トハル
it	なきこ	ナキコ
you	めあ⊍⊊	メア⍕⍁
that	⊈⊈むわい	⌿⌿ムワイ
he	⊈っとみ⊇き⊅や	⌿ットミ⌾キ⌼ヤ
was	ひま⊂ひとき⊁⊆⊅	ヒマ⌹ヒトキ⌸⌽⌼
for	みゆせよけほさんた	ミユセヨケホサンタ
on	⊁へた	⌸ヘタ
are	⊆あゔ⊃	⌽アヴ⌺
with	へのゔこと	ヘノヴコト
as	⊊⊀⊆そっひきろ	⍁⌶⌽ソッヒキロ
I	んここ▣むみな⊋	ンココ◈ムミナ⍂
his	ももやの	モモヤノ
they	おこるるこさらか	オコルルコサラカ
be	お⊄ほに⊈てに	オ⌻ホニ⌿テニ
at	こえなに	コエナニ
one	えと⊋のっとは	エト⍂ノットハ
have	⊀け⊀ろわ⊍れ	⌶ケ⌶ロワ⍕レ
this	く⊂▣うみ	ク⌹◈ウミ
from	⊂せ⊆ほけ⊃ち	⌹セ⌽ホケ⌺チ
or	⊇いりしなきせ	⌾イリシナキセ
had	ゆちこ⊊れひせ	ユチコ⍁レヒセ
by	けらへ	ケラヘ
not	あの⊂に⊍せおへ	アノ⌹ニ⍕セオヘ
word	ならす	ナラス
but	⊇と⊄せすけちに	⌾ト⌻セスケチニ
what	くはし	クハシ
some	⊅かもちきと⊁も	⌼カモチキト⌸モ
we	ほや⊅れけあわれ	ホヤ⌼レケアワレ
can	さと⊃	サト⌺
out	のな▣たには⊄て	ノナ◈タニハ⌻テ
other	りあか⊁らこ	リアカ⌸ラコ
were	てゔはの	テヴハノ
all	こかや⊌あ	コカヤ⍢ア
there	もむわゆ	モムワユ
when	⊍▣⊂	⍕◈⌹
up	ひん⊉ひた⊅に⊇て	ヒン⍀ヒタ⌼ニ⌾テ
use	おのらこいほっ⊅	オノラコイホッ⌼
your	⊅た⊊と⊉⊀	⌼タ⍁ト⍀⌶
how	るにく	ルニク
said	ななされおうろたれ	ナナサレオウロタレ
an	えひえ⊊⊉⊅もは	エヒエ⍁⍀⌼モハ
each	し⊇すれ⊆	シ⌾スレ⌽
she	⊋そ⊈そへ	⍂ソ⌿ソヘ
which	ほたみ⊀ひあはわふ	ホタミ⌶ヒアハワフ
do	ろとっふ⊂はめ	ロトッフ⌹ハメ
their	わ⊄のさ⊊さえめ	ワ⌻ノサ⍁サエメ
time	⊅な⊇ふめ	⌼ナ⌾フメ
if	れた⊃すに⊃ろ	レタ⌺スニ⌺ロ
will	ませ▣ち	マセ◈チ
way	⊄ほ⊆のなわおに	⌻ホ⌽ノナワオニ
about	くのほすせゔ⊍へ	クノホスセヴ⍕ヘ
many	⊌にえてく⊌ゆ	⍢ニエテク⍢ユ
then	けさり⊋	ケサリ⍂
them	ゔ⊋⊁⊇た	ヴ⍂⌸⌾タ
write	みもは	ミモハ
would	⊊の▣け⊁にまくす	⍁ノ◈ケ⌸ニマクス
like	に▣っや⊃たりも	ニ◈ッヤ⌺タリモ
so	め⊁⊂は	メ⌸⌹ハ
these	むにすゆめ⊄⊆え	ムニスユメ⌻⌽エ
her	⊋⊃っ	⍂⌺ッ
long	ふくゔおひもま	フクヴオヒモマ
make	えわ⊃	エワ⌺
thing	▣⊂あ	◈⌹ア
see	⊁へっん⊈うあ⊇る	⌸ヘッン⌿ウア⌾ル
him	けお⊅	ケオ⌼
two	っめむておせふ⊂	ッメムテオセフ⌹
has	よ⊇かりうえ	ヨ⌾カリウエ
look	かえ⊁にめ⊄しさ	カエ⌸ニメ⌻シサ
more	⊆すむくま⊂は	⌽スムクマ⌹ハ
day	にてあ	ニテア
could	はにんくうみ⊇りら	ハニンクウミ⌾リラ
go	へよにせ⊅み⊉⊋	ヘヨニセ⌼ミ⍀⍂
come	⊃こそゆおそ	⌺コソユオソ
did	えけえきふ	エケエキフ
number	あせ⊋ら	アセ⍂ラ
sound	すへさけかほ▣	スヘサケカホ◈
no	やむらら⊀⊀⊊⊆	ヤムララ⌶⌶⍁⌽
most	⊁⊈はお	⌸⌿ハオ
people	⊆⊇せ⊌ち⊅	⌽⌾セ⍢チ⌼
my	ゔめ⊄こむものに	ヴメ⌻コムモノニ
over	⊍ちるりひ	⍕チルリヒ
know	とやし⊀⊇う	トヤシ⌶⌾ウ
water	⊊⊂⊈	⍁⌹⌿
than	⊍のえ	⍕ノエ
call	こけし⊂すちにてに	コケシ⌹スチニテニ
first	すゆ⊄はし	スユ⌻ハシ
who	ひおその⊍ゔ	ヒオソノ⍕ヴ
may	わこすきかわ	ワコスキカワ
down	まとは⊆⊃おととか	マトハ⌽⌺オトトカ
side	⊄⊉のうて	⌻⍀ノウテ
been	ふほ⊋	フホ⍂
now	して⊌ゔ	シテ⍢ヴ
find	⊃と⊉く⊍も	⌺ト⍀ク⍕モ
any	⊁ちろ	⌸チロ
new	⊋⊉⊆う⊊⊀	⍂⍀⌽ウ⍁⌶
work	ゆけ⊍わのにろよ⊋	ユケ⍕ワノニロヨ⍂
part	と⊂⊃も⊄らさ	ト⌹⌺モ⌻ラサ
take	⊌⊃の⊃ななみ	⍢⌺ノ⌺ナナミ
get	ゆけるれち	ユケルレチ
place	ま⊃なめせな	マ⌺ナメセナ
made	ちや⊆そす	チヤ⌽ソス
live	▣よかっうれ⊍	◈ヨカッウレ⍕
where	ろ⊋っすもえと	ロ⍂ッスモエト
after	せ⊈⊃りせせて	セ⌿⌺リセセテ
back	うなやまあり	ウナヤマアリ
little	⊉れお⊂のむし	⍀レオ⌹ノムシ
only	⊈かに⊋	⌿カニ⍂
round	しな⊆⊋⊋せ⊌	シナ⌽⍂⍂セ⍢
man	むくりめそのには⊆	ムクリメソノニハ⌽
year	れ⊆こ⊁なた⊁れむ	レ⌽コ⌸ナタ⌸レム
came	⊃せゆめお⊅	⌺セユメオ⌼
show	へひそ⊍ひんむ	ヘヒソ⍕ヒンム
every	⊉なとゆい⊉くく	⍀ナトユイ⍀クク
good	てにりこに⊌り	テニリコニ⍢リ
me	⊉きほ⊋⊆り⊇れ	⍀キホ⍂⌽リ⌾レ
give	そ⊌ろけそほ	ソ⍢ロケソホ
our	れはのえすへ⊋う	レハノエスヘ⍂ウ
under	⊂⊀にのにゆえま	⌹⌶ニノニユエマ
name	よいん⊇⊀まふも	ヨイン⌾⌶マフモ
very	る⊋せめ⊇ら	ル⍂セメ⌾ラ
through	⊀う⊀あ⊇ひはこお	⌶ウ⌶ア⌾ヒハコオ
just	てこゔ⊀うよろ	テコヴ⌶ウヨロ
form	のさくほち	ノサクホチ
sentence	む⊁ちせ⊁	ム⌸チセ⌸
great	むるやうえか	ムルヤウエカ
think	さひる	サヒル
say	⊉⊇わてへす	⍀⌾ワテヘス
help	⊁⊅にひ	⌸⌼ニヒ
low	るろみのゔ	ルロミノヴ
line	まわ⊌やや⊈れ⊋や	マワ⍢ヤヤ⌿レ⍂ヤ
differ	されほに⊄ゆて▣⊀	サレホニ⌻ユテ◈⌶
turn	や⊆か▣っ⊂	ヤ⌽カ◈ッ⌹
cause	せもゆきこ	セモユキコ
much	にひは	ニヒハ
mean	⊁あ⊌ううう⊀⊁	⌸ア⍢ウウウ⌶⌸
before	⊊ひはう⊄れあ⊅ひ	⍁ヒハウ⌻レア⌼ヒ
move	ならあ	ナラア
right	なかかもらの⊊す⊁	ナカカモラノ⍁ス⌸
boy	たきむ⊅にわ	タキム⌼ニワ
old	は⊉さもう	ハ⍀サモウ
too	やへひまれけ⊌	ヤヘヒマレケ⍢
same	⊈ううるえふ	⌿ウウルエフ
tell	きくるよっ⊆ゆ	キクルヨッ⌽ユ
does	すふ⊌らか	スフ⍢ラカ
set	⊂めま⊃ふたま	⌹メマ⌺フタマ
three	ひんほ	ヒンホ
want	しせ⊁そあ▣てっち	シセ⌸ソア◈テッチ
air	⊉ほ⊌⊂⊅⊇よ⊅⊋	⍀ホ⍢⌹⌼⌾ヨ⌼⍂
well	かしく	カシク
also	わちゆわの	ワチユワノ
play	そひ⊂おへ⊉	ソヒ⌹オヘ⍀
small	そ▣そひお	ソ◈ソヒオ
end	め⊊⊊らす⊀はっら	メ⍁⍁ラス⌶ハッラ
put	した⊉おれよ⊈の	シタ⍀オレヨ⌿ノ
home	もそすえ⊄⊊⊊こ	モソスエ⌻⍁⍁コ
read	⊌こ⊊いわさ⊃は	⍢コ⍁イワサ⌺ハ
hand	っ⊈すに	ッ⌿スニ
port	ほはえあにる	ホハエアニル
large	こしはのおろ	コシハノオロ
spell	わと⊁ま▣きるた	ワト⌸マ◈キルタ
add	⊍ろ⊁かええも⊈	⍕ロ⌸カエエモ⌿
even	えふのろ	エフノロ
land	は▣のい⊈こか	ハ◈ノイ⌿コカ
here	⊆そは⊄や▣ふの	⌽ソハ⌻ヤ◈フノ
must	やく⊂ひへしひ	ヤク⌹ヒヘシヒ
big	⊃お⊈⊆	⌺オ⌿⌽
high	にはたうけにの	ニハタウケニノ
such	えに⊄た⊊	エニ⌻タ⍁
follow	ひ⊄にらゆむむ⊊わ	ヒ⌻ニラユムム⍁ワ
act	ろちかちも⊆⊄に	ロチカチモ⌽⌻ニ
why	っ⊃こほりのお	ッ⌺コホリノオ
ask	⊆りら⊆て	⌽リラ⌽テ
men	らちも⊈な⊀けろあ	ラチモ⌿ナ⌶ケロア
change	わ▣よえそめの⊋へ	ワ◈ヨエソメノ⍂ヘ
went	ふ⊀にきいの⊌ほ	フ⌶ニキイノ⍢ホ
light	う⊇⊅あえ	ウ⌾⌼アエ
kind	かほきも⊃あち	カホキモ⌺アチ
off	▣りのすっ	◈リノスッ
need	⊇おらのち	⌾オラノチ
house	ほち⊌た⊄ろ⊄よひ	ホチ⍢タ⌻ロ⌻ヨヒ
picture	⊋ほっ⊃	⍂ホッ⌺
try	むくり	ムクリ
us	よへろく	ヨヘロク
again	さゔ⊄⊁ひけむ⊆	サヴ⌻⌸ヒケム⌽
animal	す⊁⊂ゆそ⊌⊆⊄	ス⌸⌹ユソ⍢⌽⌻
point	わゆわえ⊂ちし⊈ま	ワユワエ⌹チシ⌿マ
mother	ろ⊈きゆ⊄のよ	ロ⌿キユ⌻ノヨ
world	んのかたにり	ンノカタニリ
near	▣みむわへ	◈ミムワヘ
build	しちくとくる	シチクトクル
self	にされはにそ⊃たり	ニサレハニソ⌺タリ
earth	⊄に⊇むくへ	⌻ニ⌾ムクヘ
father	も⊂か⊁⊈う	モ⌹カ⌸⌿ウ
head	いそらにふ⊃	イソラニフ⌺
stand	えにな	エニナ
own	よおちえ⊃んうそけ	ヨオチエ⌺ンウソケ
page	もにえは	モニエハ
should	⊃▣ちえなゔら	⌺◈チエナヴラ
country	⊆か⊁ひわ	⌽カ⌸ヒワ
found	むよ⊇	ムヨ⌾
answer	りてる⊀ます	リテル⌶マス
school	れきも	レキモ
grow	てめき	テメキ
study	⊁は⊊すこか⊈	⌸ハ⍁スコカ⌿
still	ひ⊂⊍ゆこよ	ヒ⌹⍕ユコヨ
learn	もさ⊀⊁むちろ⊈し	モサ⌶⌸ムチロ⌿シ
plant	みそすかえ	ミソスカエ
cover	かこのし	カコノシ
food	⊂⊃⊈⊈	⌹⌺⌿⌿
sun	せほは⊀ろ	セホハ⌶ロ
four	りも⊃	リモ⌺
between	んむふちはやすさよ	ンムフチハヤスサヨ
state	ら⊉たま⊋ろき	ラ⍀タマ⍂ロキ
keep	めす⊇に⊌	メス⌾ニ⍢
eye	やおすよ⊌れ	ヤオスヨ⍢レ
never	うなん⊀ひなてお	ウナン⌶ヒナテオ
last	い⊊そさえ⊀ゆ⊅	イ⍁ソサエ⌶ユ⌼
let	に▣いあたま	ニ◈イアタマ
thought	と⊍きふか▣⊍⊄ふ	ト⍕キフカ◈⍕⌻フ
city	▣ほの⊌ふ⊇⊌け	◈ホノ⍢フ⌾⍢ケ
tree	⊀さい▣むのろ	⌶サイ◈ムノロ
cross	ろち⊁さたのか	ロチ⌸サタノカ
farm	いえ⊉ひはふ⊌	イエ⍀ヒハフ⍢
hard	きめひふ	キメヒフ
start	⊆みくらゆ	⌽ミクラユ
might	なれか⊅⊃	ナレカ⌼⌺
story	まむさるっ	マムサルッ
saw	ふさふ	フサフ
far	きの⊆けえに	キノ⌽ケエニ
sea	かうせは⊃	カウセハ⌺
draw	⊍えてるたは	⍕エテルタハ
left	ふ⊄⊇⊍きま⊇へ	フ⌻⌾⍕キマ⌾ヘ
late	すまめ	スマメ
run	もに⊆めに⊋さ	モニ⌽メニ⍂サ
don't	⊅る⊀ほり⊁	⌼ル⌶ホリ⌸
while	なよとん	ナヨトン
press	そむも⊄▣	ソムモ⌻◈
close	む⊉ほう⊁⊁⊌ても	ム⍀ホウ⌸⌸⍢テモ
night	⊍ほるせひ⊉⊊むろ	⍕ホルセヒ⍀⍁ムロ
real	っ⊉ちにろゔ⊇	ッ⍀チニロヴ⌾
life	え⊃わとち	エ⌺ワトチ
few	そめおしほにと	ソメオシホニト
north	っらなるしこく	ッラナルシコク
open	ゔしみ	ヴシミ
seem	まか⊋め⊁し⊊ま	マカ⍂メ⌸シ⍁マ
together	う⊀きもる⊈ひ	ウ⌶キモル⌿ヒ
next	せせわゔひこに⊅	セセワヴヒコニ⌼
white	ろに⊇め	ロニ⌾メ
children	ほもえきみさひ	ホモエキミサヒ
begin	ほすわいらせま	ホスワイラセマ
got	⊅ここうとそそふ	⌼ココウトソソフ
walk	んんとすは⊁	ンントスハ⌸
example	しれけわき	シレケワキ
ease	す⊆⊃ひ	ス⌽⌺ヒ
paper	▣⊍は⊆⊇⊋	◈⍕ハ⌽⌾⍂
group	⊉⊇すな⊉おま⊉	⍀⌾スナ⍀オマ⍀
always	さへよふ	サヘヨフ
music	⊇⊇⊆ら	⌾⌾⌽ラ
those	そるみ	ソルミ
both	うにゔ	ウニヴ
mark	りゆけ⊈ゔっいほ	リユケ⌿ヴッイホ
often	ろのき⊁かん⊋か	ロノキ⌸カン⍂カ
letter	⊋はるう⊄	⍂ハルウ⌻
until	ゔれ⊋▣	ヴレ⍂◈
mile	⊌▣いや	⍢◈イヤ
river	ほ⊌の⊋⊁さ	ホ⍢ノ⍂⌸サ
car	▣ゔら⊊みまたら	◈ヴラ⍁ミマタラ
feet	ほえわきん	ホエワキン
care	⊌そちす	⍢ソチス
second	⊀ろまこれてい	⌶ロマコレテイ
book	⊂の⊃るは⊇る	⌹ノ⌺ルハ⌾ル
carry	たよ▣し	タヨ◈シ
took	えらす	エラス
science	に⊊か⊄かせに	ニ⍁カ⌻カセニ
eat	⊄⊈めけ⊂もにみ	⌻⌿メケ⌹モニミ
room	せのろ	セノロ
friend	⊀けてちたま	⌶ケテチタマ
began	へ⊄め	ヘ⌻メ
idea	⊀あま⊌そめまへめ	⌶アマ⍢ソメマヘメ
fish	れ⊋くっみけ⊆やく	レ⍂クッミケ⌽ヤク
mountain	む⊄っっむほ	ム⌻ッッムホ
stop	むもはやち⊋さ	ムモハヤチ⍂サ
once	⊆へえっ⊈う⊂ん	⌽ヘエッ⌿ウ⌹ン
base	⊀き⊌んおおほわさ	⌶キ⍢ンオオホワサ
hear	くゔな⊃に⊌ゔ	クヴナ⌺ニ⍢ヴ
horse	のっにり	ノッニリ
cut	⊄っは⊃	⌻ッハ⌺
sure	⊁えむ⊉⊉も	⌸エム⍀⍀モ
watch	にけふま⊆▣る	ニケフマ⌽◈ル
color	⊁けさやた	⌸ケサヤタ
face	ちあへしひ⊊ら	チアヘシヒ⍁ラ
wood	⊁とい⊋⊄おきわ⊅	⌸トイ⍂⌻オキワ⌼
main	⊊うやし⊈⊂	⍁ウヤシ⌿⌹
enough	⊊ゆ⊅このに⊄	⍁ユ⌼コノニ⌻
plain	い⊈すと	イ⌿スト
girl	⊉う⊃⊅う	⍀ウ⌺⌼ウ
usual	わやせいててっりせ	ワヤセイテテッリセ
young	ひ⊁みか⊆⊆	ヒ⌸ミカ⌽⌽
ready	け⊋うれくっ⊌	ケ⍂ウレクッ⍢
above	りえれせかく⊌⊈	リエレセカク⍢⌿
ever	⊍なけ	⍕ナケ
red	のけにものきみ	ノケニモノキミ
list	⊄の▣んたろっう	⌻ノ◈ンタロッウ
though	すまななう⊄ひえ	スマナナウ⌻ヒエ
feel	うすて	ウステ
talk	す⊉あらえ⊈え	ス⍀アラエ⌿エ
bird	あ⊋のあ▣ほ	ア⍂ノア◈ホ
soon	⊄おっいや⊂	⌻オッイヤ⌹
body	きいみ	キイミ
dog	⊁てるは⊂ゔっ	⌸テルハ⌹ヴッ
family	⊈このすふむすやゔ	⌿コノスフムスヤヴ
direct	ちせやみふせ⊈⊌	チセヤミフセ⌿⍢
pose	およ⊆⊅⊀わめせ⊅	オヨ⌽⌼⌶ワメセ⌼
leave	にろな⊈⊅たこ	ニロナ⌿⌼タコ
song	⊄こそ⊁⊊る	⌻コソ⌸⍁ル
measure	ふすみ⊈⊂た	フスミ⌿⌹タ
door	⊂わにむさち⊌	⌹ワニムサチ⍢
product	のさおくもるしふめ	ノサオクモルシフメ
black	おはほし⊊れ	オハホシ⍁レ
short	はっっよや⊌や	ハッッヨヤ⍢ヤ
numeral	せゆゆみはて	セユユミハテ
class	てせかにん	テセカニン
wind	なそけせ	ナソケセ
question	おきむ	オキム
happen	えふさわに⊍んにわ	エフサワニ⍕ンニワ
complete	いりめふして⊌き	イリメフシテ⍢キ
ship	ゔらもき⊀▣にも⊊	ヴラモキ⌶◈ニモ⍁
area	⊅ないなそ⊃	⌼ナイナソ⌺
half	⊅うみ	⌼ウミ
rock	⊍なのなり⊅う	⍕ナノナリ⌼ウ
order	うにき⊂⊃せ	ウニキ⌹⌺セ
fire	ゆ⊉ま⊅へと	ユ⍀マ⌼ヘト
south	た⊂か⊉おそ⊀	タ⌹カ⍀オソ⌶
problem	っ⊍そ⊉⊃せ⊀	ッ⍕ソ⍀⌺セ⌶
piece	⊃け⊀へ	⌺ケ⌶ヘ
told	のるも	ノルモ
knew	⊋⊉すなけはさ	⍂⍀スナケハサ
pass	⊅や⊀⊇ほらら	⌼ヤ⌶⌾ホララ
since	にやこ⊈	ニヤコ⌿
top	うゆとと⊁ち	ウユトト⌸チ
whole	とふの⊀か⊂⊉っそ	トフノ⌶カ⌹⍀ッソ
king	すて⊉⊁⊆ほ⊄	ステ⍀⌸⌽ホ⌻
space	かせら	カセラ
heard	▣かしらの⊇	◈カシラノ⌾
best	のかえ⊌あふふのけ	ノカエ⍢アフフノケ
hour	さあくしこお⊄	サアクシコオ⌻
better	⊂し⊈せさむも⊉	⌹シ⌿セサムモ⍀
true	よほりこ▣ろは	ヨホリコ◈ロハ
during	ゆゆわむんすそ	ユユワムンスソ
hundred	お⊋ゔり	オ⍂ヴリ
five	⊄さけ	⌻サケ
remember	⊅ゔえは⊌	⌼ヴエハ⍢
step	けめや⊆	ケメヤ⌽
early	ろりきんに⊌	ロリキンニ⍢
hold	かにみ▣くいは	カニミ◈クイハ
west	ほろ⊃らえく⊊みろ	ホロ⌺ラエク⍁ミロ
ground	⊇⊈⊀▣ゔしけ	⌾⌿⌶◈ヴシケ
interest	あしえめあく	アシエメアク
reach	りふあんゔ	リフアンヴ
fast	⊆ななこやえな⊈	⌽ナナコヤエナ⌿
verb	こる⊄	コル⌻
sing	き⊇す⊃ろさ⊉	キ⌾ス⌺ロサ⍀
listen	す⊍ほろもけ	ス⍕ホロモケ
six	るそろのきい	ルソロノキイ
table	く⊃えめて⊋おの	ク⌺エメテ⍂オノ
travel	まませろ	ママセロ
less	ちはんたゆて	チハンタユテ
morning	の⊌いらむほなえ⊀	ノ⍢イラムホナエ⌶
ten	みあ⊈⊂そら	ミア⌿⌹ソラ
simple	ちに⊇	チニ⌾
several	ま▣となに	マ◈トナニ
vowel	に⊄かもふく⊈ろす	ニ⌻カモフク⌿ロス
toward	たふあ⊄⊌	タフア⌻⍢
war	き⊈よや	キ⌿ヨヤ
lay	もけかはるへに⊂わ	モケカハルヘニ⌹ワ
against	⊁るのう⊄	⌸ルノウ⌻
pattern	ち⊇けくの⊇⊊	チ⌾ケクノ⌾⍁
slow	ひんら⊃	ヒンラ⌺
center	て⊂⊍か	テ⌹⍕カ
love	んの⊌あま⊀⊄む	ンノ⍢アマ⌶⌻ム
person	よさおち	ヨサオチ
money	め▣のむ⊋お▣め	メ◈ノム⍂オ◈メ
serve	っしこ⊁ふ⊉	ッシコ⌸フ⍀
appear	まむ⊋	マム⍂
road	のへえ⊇ままめふ	ノヘエ⌾ママメフ
map	りも⊌もり⊉	リモ⍢モリ⍀
rain	そと⊀とた⊆る⊅は	ソト⌶トタ⌽ル⌼ハ
rule	⊁ちに	⌸チニ
govern	にすん	ニスン
pull	らかみえり⊃たらき	ラカミエリ⌺タラキ
cold	おあむほあゔたんな	オアムホアヴタンナ
notice	たくら⊈ゆみせ	タクラ⌿ユミセ
voice	⊄みひらなみきり	⌻ミヒラナミキリ
unit	い⊆ちあ⊍んの	イ⌽チア⍕ンノ
power	⊌よしは	⍢ヨシハ
town	りもに⊅るお▣⊆	リモニ⌼ルオ◈⌽
fine	らとき⊀みやにきる	ラトキ⌶ミヤニキル
certain	もんりゔえ	モンリヴエ
fly	せろ⊆お	セロ⌽オ
fall	もせたなそよ	モセタナソヨ
lead	やへののふなこりみ	ヤヘノノフナコリミ
cry	もみえ	モミエ
dark	なすなひ⊆かやわ	ナスナヒ⌽カヤワ
machine	りわ⊁っゆや	リワ⌸ッユヤ
note	せとめ	セトメ
wait	れむ⊃へちそひ	レム⌺ヘチソヒ
plan	ちらふきとめ	チラフキトメ
figure	ひえ⊅せ	ヒエ⌼セ
star	く⊂⊉せ	ク⌹⍀セ
box	う⊄いほみ⊀り	ウ⌻イホミ⌶リ
noun	か⊌れ⊊⊆⊀なこり	カ⍢レ⍁⌽⌶ナコリ
field	⊍むて⊁ん	⍕ムテ⌸ン
rest	▣⊄たえんお▣⊄お	◈⌻タエンオ◈⌻オ
correct	んくけし	ンクケシ
able	むろえゆ⊊	ムロエユ⍁
pound	あすえは⊀りえ	アスエハ⌶リエ
done	かす⊉▣きと⊀ひ	カス⍀◈キト⌶ヒ
beauty	へ⊀し⊀きり	ヘ⌶シ⌶キリ
drive	ゆしおふそ	ユシオフソ
stood	ゔえちなち	ヴエチナチ
contain	⊃⊁⊅は⊄お	⌺⌸⌼ハ⌻オ
front	⊂⊍け⊉⊄	⌹⍕ケ⍀⌻
teach	みたえ	ミタエ
week	り⊋そそ⊍もる	リ⍂ソソ⍕モル
final	け⊉⊇	ケ⍀⌾
gave	▣ほ⊅の⊅せ⊃	◈ホ⌼ノ⌼セ⌺
green	ろと⊇のめれへ	ロト⌾ノメレヘ
oh	ちへさま⊁ひ⊃⊀ん	チヘサマ⌸ヒ⌺⌶ン
quick	やすの	ヤスノ
develop	⊋⊊りめっにこ⊈ら	⍂⍁リメッニコ⌿ラ
ocean	⊊うもし⊌⊁ち	⍁ウモシ⍢⌸チ
warm	く⊄⊉い	ク⌻⍀イ
free	れ⊊このやめ	レ⍁コノヤメ
minute	ゆ⊋さっほ	ユ⍂サッホ
strong	えう⊇⊉ゆこ	エウ⌾⍀ユコ
special	⊂と⊇めか	⌹ト⌾メカ
mind	りしえんんきにすろ	リシエンンキニスロ
behind	ほゔり	ホヴリ
clear	と⊆⊃と⊅ん⊌	ト⌽⌺ト⌼ン⍢
tail	⊇めう⊆んとた	⌾メウ⌽ントタ
produce	さちすはかいと⊆	サチスハカイト⌽
fact	ひほれれ	ヒホレレ
street	きい⊃⊁そひ	キイ⌺⌸ソヒ
inch	⊉⊋ら⊂ののろき	⍀⍂ラ⌹ノノロキ
multiply	やいひく	ヤイヒク
nothing	ゔえす	ヴエス
course	すろ⊉て▣て	スロ⍀テ◈テ
stay	むこう⊉⊄こ▣も	ムコウ⍀⌻コ◈モ
wheel	めのく	メノク
full	▣ゆ⊉へ⊇そ⊄らの	◈ユ⍀ヘ⌾ソ⌻ラノ
force	▣▣ろう	◈◈ロウ
blue	るすさ	ルスサ
object	⊃⊄やお⊅ふりわ⊈	⌺⌻ヤオ⌼フリワ⌿
decide	⊆せら⊅にてやゔ	⌽セラ⌼ニテヤヴ
surface	さ⊍らもに⊌	サ⍕ラモニ⍢
deep	はおこ⊍	ハオコ⍕
moon	るてさしわこら	ルテサシワコラ
island	るち⊉⊆ほ	ルチ⍀⌽ホ
foot	ゔやてのま	ヴヤテノマ
system	のて⊇▣へ⊈の	ノテ⌾◈ヘ⌿ノ
busy	っま⊄むるみろやほ	ッマ⌻ムルミロヤホ
test	と⊅⊌と	ト⌼⍢ト
record	みむまゔおみのる	ミムマヴオミノル
boat	そきっのかちたら	ソキッノカチタラ
common	もそう⊅えんのん	モソウ⌼エンノン
gold	ふまおろとめ⊄	フマオロトメ⌻
possible	お⊋そにこ	オ⍂ソニコ
plane	かけのらゆにろふも	カケノラユニロフモ
stead	たしゆ	タシユ
dry	ろ⊋⊇	ロ⍂⌾
wonder	れちりてきろこそこ	レチリテキロコソコ
laugh	⊉⊉た⊆▣⊇	⍀⍀タ⌽◈⌾
thousand	らひ⊌に⊁ら⊉⊊	ラヒ⍢ニ⌸ラ⍀⍁
ago	ともや⊈そな▣ひ	トモヤ⌿ソナ◈ヒ
ran	しめえんの⊇	シメエンノ⌾
check	たかて⊀のりな	タカテ⌶ノリナ
game	くしゔわす⊃⊇	クシヴワス⌺⌾
shape	のゔよそ⊇やく	ノヴヨソ⌾ヤク
equate	みのちやせ⊊	ミノチヤセ⍁
hot	おくなの	オクナノ
miss	ゔまて⊇く	ヴマテ⌾ク
brought	⊈ほあこ	⌿ホアコ
heat	うゔ▣えひ⊍	ウヴ◈エヒ⍕
snow	かまに⊇か⊈かちき	カマニ⌾カ⌿カチキ
tire	くち⊇の	クチ⌾ノ
bring	にせま⊊▣の⊈	ニセマ⍁◈ノ⌿
yes	てりせしす	テリセシス
distant	ま⊁いっわま⊌	マ⌸イッワマ⍢
fill	よろふひの⊈	ヨロフヒノ⌿
east	えよら	エヨラ
paint	むと⊁い⊇ほ	ムト⌸イ⌾ホ
language	⊁まも▣こ⊄	⌸マモ◈コ⌻
among	てころ⊄れ⊅	テコロ⌻レ⌼
grand	ひとほ	ヒトホ
ball	▣かち⊅まゔあ⊂	◈カチ⌼マヴア⌹
yet	はらてほ⊋⊅け⊃	ハラテホ⍂⌼ケ⌺
wave	ゆ▣す	ユ◈ス
drop	⊉ゆっほき⊆	⍀ユッホキ⌽
heart	めけわ⊉そひ	メケワ⍀ソヒ
am	っか⊌⊃ら	ッカ⍢⌺ラ
present	とせ⊂	トセ⌹
heavy	⊁⊇しお⊂	⌸⌾シオ⌹
dance	のんろけみ	ノンロケミ
engine	りわ⊉るやち	リワ⍀ルヤチ
position	いりよ	イリヨ
arm	⊊あとはちよほ	⍁アトハチヨホ
wide	き⊇いまにくにすっ	キ⌾イマニクニスッ
sail	⊈⊉⊋⊂ゔ⊆⊃⊃	⌿⍀⍂⌹ヴ⌽⌺⌺
material	えゆのへたとあんっ	エユノヘタトアンッ
size	れり⊆の	レリ⌽ノ
vary	も⊅め⊇こ	モ⌼メ⌾コ
settle	めてへる	メテヘル
speak	そあくすた⊌お⊅	ソアクスタ⍢オ⌼
weight	んお⊂えふしけ	ンオ⌹エフシケ
general	たさそ	タサソ
ice	はかああめゆも	ハカアアメユモ
matter	⊉てし	⍀テシ
circle	く⊇さ	ク⌾サ
pair	ふひ⊊っあ	フヒ⍁ッア
include	にひめれや	ニヒメレヤ
divide	んゆむせ⊊ゔは⊅れ	ンユムセ⍁ヴハ⌼レ
syllable	⊁⊁かせんま	⌸⌸カセンマ
felt	▣まいり	◈マイリ
perhaps	よふそは⊁	ヨフソハ⌸
pick	⊅せなにか	⌼セナニカ
sudden	⊃てひは	⌺テヒハ
count	⊄⊆は⊄⊌み⊉	⌻⌽ハ⌻⍢ミ⍀
square	りめ⊇⊋む⊁ゆ	リメ⌾⍂ム⌸ユ
reason	たす⊆ち⊊ののこ⊌	タス⌽チ⍁ノノコ⍢
length	⊋ひにた	⍂ヒニタ
represent	のに⊊はわ⊉はんひ	ノニ⍁ハワ⍀ハンヒ
art	しこしらむしさ	シコシラムシサ
subject	ものろ⊃え⊊	モノロ⌺エ⍁
region	⊂き⊈に⊍ほかり	⌹キ⌿ニ⍕ホカリ
energy	のなり⊂せこ	ノナリ⌹セコ
hunt	くおっ	クオッ
probable	としこそきとりなけ	トシコソキトリナケ
bed	み⊂けひふら⊅に	ミ⌹ケヒフラ⌼ニ
brother	みれな	ミレナ
egg	んら⊂	ンラ⌹
ride	⊈のもし⊂ふんきみ	⌿ノモシ⌹フンキミ
cell	ろ⊇らりゆなっ	ロ⌾ラリユナッ
believe	さわ⊅ゆよせ	サワ⌼ユヨセ
fraction	⊊す⊂⊈も	⍁ス⌹⌿モ
forest	し⊂⊉	シ⌹⍀
sit	てんやよきさやのえ	テンヤヨキサヤノエ
race	⊉⊊⊈ろいにっさ	⍀⍁⌿ロイニッサ
window	とわころら⊀よめる	トワコロラ⌶ヨメル
store	▣▣へそ⊆ゆすれ	◈◈ヘソ⌽ユスレ
summer	ふみさ⊀⊂	フミサ⌶⌹
train	よ⊅お⊋ひけ⊊	ヨ⌼オ⍂ヒケ⍁
sleep	るかさ	ルカサ
prove	ふ⊃や⊊	フ⌺ヤ⍁
lone	まのくくれひそふよ	マノククレヒソフヨ
leg	れほんく⊊	レホンク⍁
exercise	⊄⊍む⊉るてよ	⌻⍕ム⍀ルテヨ
wall	ちいまれと⊇ん	チイマレト⌾ン
catch	りほせ⊅⊊か⊅⊅	リホセ⌼⍁カ⌼⌼
mount	にゆふ⊅⊇む	ニユフ⌼⌾ム
wish	⊀えほの⊁め⊆	⌶エホノ⌸メ⌽
sky	のふに⊁みあおい	ノフニ⌸ミアオイ
board	ひわ⊇にらき	ヒワ⌾ニラキ
joy	⊌にりやれ	⍢ニリヤレ
winter	っらきち▣ほけ⊂	ッラキチ◈ホケ⌹
sat	▣けちろ▣	◈ケチロ◈
written	やくおにわちも	ヤクオニワチモ
wild	⊌むよろ⊆る⊃⊅と	⍢ムヨロ⌽ル⌺⌼ト
instrument	⊁ひかし	⌸ヒカシ
kept	けゆけもに⊃⊋	ケユケモニ⌺⍂
glass	みよめれそなゆく▣	ミヨメレソナユク◈
grass	さ⊀ゆおと⊇っゔ⊇	サ⌶ユオト⌾ッヴ⌾
cow	のうせや⊅ん	ノウセヤ⌼ン
job	⊍う⊈	⍕ウ⌿
edge	け⊈ろてっっま	ケ⌿ロテッッマ
sign	に⊆てそ	ニ⌽テソ
visit	なのれ⊄にゔ⊈	ナノレ⌻ニヴ⌿
past	るくみ	ルクミ
soft	めも▣	メモ◈
fun	こかほ	コカホ
bright	⊀わさちち⊋りふ	⌶ワサチチ⍂リフ
gas	とわむそうも⊇にし	トワムソウモ⌾ニシ
weather	りすもあ	リスモア
month	しささころお⊂ろ	シササコロオ⌹ロ
million	たしのかころの	タシノカコロノ
bear	へへりて⊉▣え⊊う	ヘヘリテ⍀◈エ⍁ウ
finish	ゔら⊊けしえふさ⊀	ヴラ⍁ケシエフサ⌶
happy	にるり⊇む⊀⊂	ニルリ⌾ム⌶⌹
hope	なころ	ナコロ
flower	ま⊆▣す	マ⌽◈ス
clothe	わみいいそ⊁こ	ワミイイソ⌸コ
strange	なほ⊅め	ナホ⌼メ
gone	⊍あちか⊍⊀⊇ひわ	⍕アチカ⍕⌶⌾ヒワ
jump	れ⊁けっむ	レ⌸ケッム
baby	かてむわ	カテムワ
eight	もき⊀そせにわかみ	モキ⌶ソセニワカミ
village	むひはむよ	ムヒハムヨ
meet	せすえ⊅	セスエ⌼
root	ほ⊁わえ⊉なそん	ホ⌸ワエ⍀ナソン
buy	⊈やわ	⌿ヤワ
raise	そにとふ⊍に⊈⊆⊂	ソニトフ⍕ニ⌿⌽⌹
solve	ほもいまみもみふろ	ホモイマミモミフロ
metal	⊊⊀よかてま	⍁⌶ヨカテマ
whether	⊉ほえお	⍀ホエオ
push	⊀⊋⊁⊂め⊉⊋	⌶⍂⌸⌹メ⍀⍂
seven	ふ⊍⊃るなえほ⊊⊅	フ⍕⌺ルナエホ⍁⌼
paragraph	り⊌ら⊆	リ⍢ラ⌽
third	ゔ⊀とにそよも	ヴ⌶トニソヨモ
shall	にほり	ニホリ
held	ゆ⊍⊂ちえむ⊊	ユ⍕⌹チエム⍁
hair	こえか⊃⊀るや⊇	コエカ⌺⌶ルヤ⌾
describe	⊄おこ	⌻オコ
cook	ふて⊁⊉へお⊃へな	フテ⌸⍀ヘオ⌺ヘナ
floor	ん⊀みさ⊆るゔろへ	ン⌶ミサ⌽ルヴロヘ
either	⊁きてむさむふの⊊	⌸キテムサムフノ⍁
result	すそくさ⊌ゆい⊊	スソクサ⍢ユイ⍁
burn	⊆しよれ⊇と	⌽シヨレ⌾ト
hill	たみ⊉まちにるゆひ	タミ⍀マチニルユヒ
safe	⊉そはわち⊅⊁た⊀	⍀ソハワチ⌼⌸タ⌶
cat	たえへろきさうよ⊆	タエヘロキサウヨ⌽
century	お⊋け	オ⍂ケ
consider	⊆う⊁せゔ	⌽ウ⌸セヴ
type	こるっん⊍⊅	コルッン⍕⌼
law	もふせ⊊	モフセ⍁
bit	かほに⊋うに	カホニ⍂ウニ
coast	ことほむむ	コトホムム
copy	⊊▣ゆいに⊍きくし	⍁◈ユイニ⍕キクシ
phrase	▣⊊⊁んてりにた	◈⍁⌸ンテリニタ
silent	っにおそ⊅ろま⊂	ッニオソ⌼ロマ⌹
tall	た⊌むれろ	タ⍢ムレロ
sand	ほっりう⊉	ホッリウ⍀
soil	ん⊅⊆⊉き⊅⊄⊂	ン⌼⌽⍀キ⌼⌻⌹
roll	と⊃せ⊆	ト⌺セ⌽
temperature	⊋⊀あ⊌ほん⊅す⊌	⍂⌶ア⍢ホン⌼ス⍢
finger	すろ⊀にせかいのり	スロ⌶ニセカイノリ
industry	ふさふなに⊉こく	フサフナニ⍀コク
value	⊅む⊈⊀れ	⌼ム⌿⌶レ
fight	⊇やいほゆめ	⌾ヤイホユメ
lie	ににま	ニニマ
beat	⊋⊇めちゆ	⍂⌾メチユ
excite	は⊂め	ハ⌹メ
natural	はけへ	ハケヘ
view	やす⊀しふみち	ヤス⌶シフミチ
sense	そたにま⊌	ソタニマ⍢
ear	⊆たらた⊆⊇て	⌽タラタ⌽⌾テ
else	も⊊に	モ⍁ニ
quite	⊄れ▣かたんうはひ	⌻レ◈カタンウハヒ
broke	まれに⊆え	マレニ⌽エ
case	⊉ろひとよもるき	⍀ロヒトヨモルキ
middle	ふになさ	フニナサ
kill	ち⊇さむ	チ⌾サム
son	ろ⊍ろほふ⊂れ▣よ	ロ⍕ロホフ⌹レ◈ヨ
lake	⊋まむれあひ	⍂マムレアヒ
moment	⊇ろ⊅らうせ	⌾ロ⌼ラウセ
scale	⊉⊅まほ⊁こま⊇は	⍀⌼マホ⌸コマ⌾ハ
loud	りむのせ⊍しっもあ	リムノセ⍕シッモア
spring	ふれかあえっ⊆はあ	フレカアエッ⌽ハア
observe	ちゔあ	チヴア
child	⊊へろ	⍁ヘロ
straight	むやわれろ	ムヤワレロ
consonant	へみはひお⊍	ヘミハヒオ⍕
nation	にいに⊉にやに▣	ニイニ⍀ニヤニ◈
dictionary	⊃みっ⊍もお⊈らえ	⌺ミッ⍕モオ⌿ラエ
milk	えへの	エヘノ
speed	んゔ⊇くっときれ	ンヴ⌾クットキレ
method	うやて	ウヤテ
organ	ららに⊁むそ	ララニ⌸ムソ
pay	こす⊁⊍ろっ	コス⌸⍕ロッ
age	ひあ⊊る	ヒア⍁ル
section	ふ⊍みゔきたへふ	フ⍕ミヴキタヘフ
dress	なのゔわい⊀ゔまい	ナノヴワイ⌶ヴマイ
cloud	やおたる	ヤオタル
surprise	⊁⊈⊇け⊂⊆	⌸⌿⌾ケ⌹⌽
quiet	きよ⊍もす	キヨ⍕モス
stone	まへ⊈	マヘ⌿
tiny	⊁さ⊈な⊀はひえ	⌸サ⌿ナ⌶ハヒエ
climb	⊍⊌れ⊂	⍕⍢レ⌹
cool	め⊉ひま	メ⍀ヒマ
design	なめゔち⊅⊁	ナメヴチ⌼⌸
poor	んろきにきす	ンロキニキス
lot	らっに⊅させほ⊇	ラッニ⌼サセホ⌾
experiment	むいすの⊂み	ムイスノ⌹ミ
bottom	そきおめせ	ソキオメセ
key	へたっほそそよ⊂	ヘタッホソソヨ⌹
iron	こうほる	コウホル
single	り⊆め	リ⌽メ
stick	くけ⊂おゆそん	クケ⌹オユソン
flat	れ⊅ゔ⊍	レ⌼ヴ⍕
twenty	わ⊂かりひと	ワ⌹カリヒト
skin	⊀ゔへ⊁⊁りゔ⊁	⌶ヴヘ⌸⌸リヴ⌸
smile	ち⊆いさすさき⊍	チ⌽イサスサキ⍕
crease	しわほまほはよ	シワホマホハヨ
hole	⊋もろし⊇⊋	⍂モロシ⌾⍂
trade	すとみんたたろすの	ストミンタタロスノ
melody	えて⊂⊌えみ	エテ⌹⍢エミ
trip	⊍のんけあのい⊀	⍕ノンケアノイ⌶
office	と⊌ゆへ⊃⊀え⊄	ト⍢ユヘ⌺⌶エ⌻
receive	か⊈てりお	カ⌿テリオ
row	たおみもせこん⊃さ	タオミモセコン⌺サ
mouth	なようよ	ナヨウヨ
exact	⊂ちしよか	⌹チシヨカ
symbol	りるれ⊁けひ⊅の⊅	リルレ⌸ケヒ⌼ノ⌼
die	⊋ゆれもせあ	⍂ユレモセア
least	へすめ	ヘスメ
trouble	さに⊄めこくせの	サニ⌻メコクセノ
shout	みけもも⊀むたま	ミケモモ⌶ムタマ
except	さ⊇とまんよそ	サ⌾トマンヨソ
wrote	⊋せう	⍂セウ
seed	わ⊂りののりたるの	ワ⌹リノノリタルノ
tone	⊂めくえ⊀⊈え⊇	⌹メクエ⌶⌿エ⌾
join	せほしせきれる	セホシセキレル
suggest	ち⊉き	チ⍀キ
clean	み⊃おす⊀いて⊊	ミ⌺オス⌶イテ⍁
break	にむとるなちせ⊁	ニムトルナチセ⌸
lady	かきとら	カキトラ
yard	すあ⊊	スア⍁
rise	⊋おいさも⊌	⍂オイサモ⍢
bad	も⊉⊈へるて	モ⍀⌿ヘルテ
blow	⊄きてっ⊆ろえか	⌻キテッ⌽ロエカ
oil	れせはさ	レセハサ
blood	⊁む⊍け	⌸ム⍕ケ
touch	てそ⊋けんひに	テソ⍂ケンヒニ
grew	ゆさ▣る	ユサ◈ル
cent	⊂おく⊍	⌹オク⍕
mix	⊍⊂そ	⍕⌹ソ
team	によ⊃ゔる⊀のかほ	ニヨ⌺ヴル⌶ノカホ
wire	もあおんせ⊉もふえ	モアオンセ⍀モフエ
cost	もら⊋ほうれせはう	モラ⍂ホウレセハウ
lost	もふ⊋⊈⊈へま	モフ⍂⌿⌿ヘマ
brown	▣⊅に⊆⊃⊌	◈⌼ニ⌽⌺⍢
wear	みたあ⊌は	ミタア⍢ハ
garden	にみおに⊉の	ニミオニ⍀ノ
equal	れの⊊ろ	レノ⍁ロ
sent	けく⊋り▣ゆにい▣	ケク⍂リ◈ユニイ◈
choose	⊍⊌あれ	⍕⍢アレ
fell	のひえおなほ	ノヒエオナホ
fit	くへふお⊋らゆ	クヘフオ⍂ラユ
flow	くあ⊃まひくまと	クア⌺マヒクマト
fair	よそむろも	ヨソムロモ
bank	けのゔほ	ケノヴホ
collect	はるひ⊂⊀な	ハルヒ⌹⌶ナ
save	さ⊇⊅ふ⊉	サ⌾⌼フ⍀
control	れよふせさか⊌	レヨフセサカ⍢
decimal	っあ⊂う⊃きの⊉⊉	ッア⌹ウ⌺キノ⍀⍀
gentle	⊅⊌ゔさ⊄め	⌼⍢ヴサ⌻メ
woman	よす⊅けちせ	ヨス⌼ケチセ
captain	なくのさおゆ⊍⊃	ナクノサオユ⍕⌺
practice	⊅まさえにやけせっ	⌼マサエニヤケセッ
separate	もやや	モヤヤ
difficult	お⊄めれ⊅な⊈る	オ⌻メレ⌼ナ⌿ル
doctor	もや⊉⊉	モヤ⍀⍀
please	⊇えうゆよかゆ	⌾エウユヨカユ
protect	かん⊃に⊍⊈へ	カン⌺ニ⍕⌿ヘ
noon	ちしそ⊂ゆほ	チシソ⌹ユホ
whose	ゔうりはもも	ヴウリハモモ
locate	はへよ⊈すにっむ	ハヘヨ⌿スニッム
ring	なちみひ⊁⊂わたせ	ナチミヒ⌸⌹ワタセ
character	むれ⊂ゔみ	ムレ⌹ヴミ
insect	⊉さへ▣かひ⊇	⍀サヘ◈カヒ⌾
caught	う⊁⊋かきりか	ウ⌸⍂カキリカ
period	のな⊀られ	ノナ⌶ラレ
indicate	⊀せれのう	⌶セレノウ
radio	あ⊁み⊂⊁⊌わる	ア⌸ミ⌹⌸⍢ワル
spoke	⊊さそ	⍁サソ
atom	⊃はえ⊍い	⌺ハエ⍕イ
human	きおへ⊂て	キオヘ⌹テ
history	わよ⊁とけわも	ワヨ⌸トケワモ
effect	の▣ほと⊈せそほり	ノ◈ホト⌿セソホリ
electric	ゆにまと	ユニマト
expect	かいきおすや⊂すせ	カイキオスヤ⌹スセ
crop	ののあ	ノノア
modern	たいすめえ⊄⊉るお	タイスメエ⌻⍀ルオ
element	うえよゆ	ウエヨユ
hit	っっくみく	ッックミク
student	れは⊆なに⊂⊂	レハ⌽ナニ⌹⌹
corner	せはのす	セハノス
party	しうひもえんう	シウヒモエンウ
supply	しこしす	シコシス
bone	そ⊌おれ▣もらっや	ソ⍢オレ◈モラッヤ
rail	⊃さ⊇なほせ⊅⊈	⌺サ⌾ナホセ⌼⌿
imagine	きくくまた⊂う	キククマタ⌹ウ
provide	ち⊍え	チ⍕エ
agree	か⊋んに⊈	カ⍂ンニ⌿
thus	んとてのゔせらた	ントテノヴセラタ
capital	めさ⊈	メサ⌿
won't	っみむか▣	ッミムカ◈
chair	すろせひあ⊄⊉な	スロセヒア⌻⍀ナ
danger	めろそま⊇はもほ	メロソマ⌾ハモホ
fruit	てとふくひまもす	テトフクヒマモス
rich	けっ⊌け	ケッ⍢ケ
thick	みいろに⊆なお	ミイロニ⌽ナオ
soldier	へわ⊋く⊍いもか	ヘワ⍂ク⍕イモカ
process	て⊉っ⊌	テ⍀ッ⍢
operate	も⊅くりかみ	モ⌼クリカミ
guess	しして⊌ゔくえ	シシテ⍢ヴクエ
necessary	⊍すみう	⍕スミウ
sharp	にっゆ⊆っかみま	ニッユ⌽ッカミマ
wing	⊄ゆせひ	⌻ユセヒ
create	のひこあう⊋ら	ノヒコアウ⍂ラ
neighbor	けえっみこゔ	ケエッミコヴ
wash	あひうるにる⊊あり	アヒウルニル⍁アリ
bat	ふてま⊍へろ⊁	フテマ⍕ヘロ⌸
rather	ともへ⊀りや	トモヘ⌶リヤ
crowd	うゔ⊋ちううこ	ウヴ⍂チウウコ
corn	⊀⊆⊋めいくた	⌶⌽⍂メイクタ
compare	▣おな⊅⊄⊀あま	◈オナ⌼⌻⌶アマ
poem	う⊀ゆさすくとへに	ウ⌶ユサスクトヘニ
string	むれあ⊄	ムレア⌻
bell	ここっす	ココッス
depend	⊉れた⊅⊁ら	⍀レタ⌼⌸ラ
meat	にせっみえ	ニセッミエ
rub	⊆のみ⊌	⌽ノミ⍢
tube	よ▣よよこもろ	ヨ◈ヨヨコモロ
famous	いれなっうけへけ	イレナッウケヘケ
dollar	⊆はちへち	⌽ハチヘチ
stream	もそ⊇⊈わ	モソ⌾⌿ワ
fear	⊀のけ⊇ゔは	⌶ノケ⌾ヴハ
sight	むれそん⊇	ムレソン⌾
thin	りな⊍	リナ⍕
triangle	ろちな⊋⊈のうち	ロチナ⍂⌿ノウチ
planet	こゆけのまむに	コユケノマムニ
hurry	のむすたき⊉む	ノムスタキ⍀ム
chief	え⊁のり⊃⊂き	エ⌸ノリ⌺⌹キ
colony	さしろ⊈なしけゔ	サシロ⌿ナシケヴ
clock	んか⊅ひの	ンカ⌼ヒノ
mine	⊂⊄か⊇むの⊍さゔ	⌹⌻カ⌾ムノ⍕サヴ
tie	れまほ⊁きお⊃	レマホ⌸キオ⌺
enter	そてほうのら	ソテホウノラ
major	んほま	ンホマ
fresh	まやよもの⊍⊋	マヤヨモノ⍕⍂
search	のるふやゔ⊄るこい	ノルフヤヴ⌻ルコイ
send	▣すめよなく	◈スメヨナク
yellow	えにめろ	エニメロ
gun	⊌せ⊊よか	⍢セ⍁ヨカ
allow	よ⊃⊉ら	ヨ⌺⍀ラ
print	かふ⊊ゔ⊀	カフ⍁ヴ⌶
dead	うりなすかと	ウリナスカト
spot	ほたし	ホタシ
desert	き⊍ふろ	キ⍕フロ
suit	んち⊊はまふ⊃⊈	ンチ⍁ハマフ⌺⌿
current	まにいしりるゆ⊁の	マニイシリルユ⌸ノ
lift	むりひへちもゔうん	ムリヒヘチモヴウン
rose	⊇たきれえん⊃わ	⌾タキレエン⌺ワ
continue	て⊇ゔや⊇	テ⌾ヴヤ⌾
block	やほ⊄⊈すむ	ヤホ⌻⌿スム
chart	こんくち⊆く⊉▣	コンクチ⌽ク⍀◈
hat	ゆさゆか⊄うさ	ユサユカ⌻ウサ
sell	え⊉か	エ⍀カ
success	ちせはけゆ▣よきる	チセハケユ◈ヨキル
company	わんあてこなた	ワンアテコナタ
subtract	⊅もめろもて⊍	⌼モメロモテ⍕
event	ははすとくにほ⊊	ハハストクニホ⍁
particular	⊌さのわ⊀⊆むなに	⍢サノワ⌶⌽ムナニ
deal	▣か▣⊂	◈カ◈⌹
swim	あのひ▣⊅	アノヒ◈⌼
term	む⊃ち	ム⌺チ
opposite	⊌まひり	⍢マヒリ
wife	ほゔると⊇⊍⊍	ホヴルト⌾⍕⍕
shoe	るえい	ルエイ
shoulder	いえわたいく	イエワタイク
spread	⊃⊅そくるもすまゔ	⌺⌼ソクルモスマヴ
arrange	ふよっわき⊍な	フヨッワキ⍕ナ
camp	す⊆⊀▣	ス⌽⌶◈
invent	⊉と⊀え	⍀ト⌶エ
cotton	⊂ふおほくろへき	⌹フオホクロヘキ
born	うゆてにま⊀ほ	ウユテニマ⌶ホ
determine	かおたてみ	カオタテミ
quart	⊆れものたと	⌽レモノタト
nine	⊆⊇ら⊍⊃へ⊆⊁ち	⌽⌾ラ⍕⌺ヘ⌽⌸チ
truck	▣⊇ひかのおちら	◈⌾ヒカノオチラ
noise	⊍わさ	⍕ワサ
level	さゆろち	サユロチ
chance	⊇⊆ひに	⌾⌽ヒニ
gather	め⊅に⊋⊉うてむわ	メ⌼ニ⍂⍀ウテムワ
shop	ひあいにんへら	ヒアイニンヘラ
stretch	けみ⊈あとか⊀	ケミ⌿アトカ⌶
throw	たや⊇⊃	タヤ⌾⌺
shine	⊅けいこにれ	⌼ケイコニレ
property	⊌れさ	⍢レサ
column	⊈⊀け⊋	⌿⌶ケ⍂
molecule	まみのれ⊃せ	マミノレ⌺セ
select	しやあくるう⊅	シヤアクルウ⌼
wrong	す⊆⊌⊁へ	ス⌽⍢⌸ヘ
gray	おいな⊋そ⊊ろ⊌⊂	オイナ⍂ソ⍁ロ⍢⌹
repeat	み⊁さま	ミ⌸サマ
require	⊄にはう⊄⊁	⌻ニハウ⌻⌸
broad	ちた⊃やえほへ	チタ⌺ヤエホヘ
prepare	⊁⊊も⊁に⊀	⌸⍁モ⌸ニ⌶
salt	とほへそ	トホヘソ
nose	お⊍こ⊆やく	オ⍕コ⌽ヤク
plural	いふちものき	イフチモノキ
anger	とはっみうそ⊉て	トハッミウソ⍀テ
claim	こにろ⊃へけう	コニロ⌺ヘケウ
continent	なにわはくて⊈	ナニワハクテ⌿
oxygen	い⊍らせみむ⊈る	イ⍕ラセミム⌿ル
sugar	せ▣まみそ	セ◈マミソ
death	ふに⊅いす⊁⊌しき	フニ⌼イス⌸⍢シキ
pretty	⊌せは	⍢セハ
skill	のるんう⊂お⊁おあ	ノルンウ⌹オ⌸オア
women	こうひかてゆほれ	コウヒカテユホレ
season	ふは⊊⊌ま▣	フハ⍁⍢マ◈
solution	わらゆけらみ	ワラユケラミ
magnet	そこん⊋や	ソコン⍂ヤ
silver	すか⊀	スカ⌶
thank	ゆ⊂⊃	ユ⌹⌺
branch	あ⊀への	ア⌶ヘノ
match	⊃にみ⊅⊇⊄	⌺ニミ⌼⌾⌻
suffix	にさおとふま	ニサオトフマ
especially	すほさもゔ	スホサモヴ
fig	へはんち	ヘハンチ
afraid	わこおいす	ワコオイス
huge	こえれゔせむ	コエレヴセム
sister	ゔ⊅なかきけ	ヴ⌼ナカキケ
steel	⊄ゆ⊈んななゔ	⌻ユ⌿ンナナヴ
discuss	⊌⊃んあ⊉	⍢⌺ンア⍀
forward	のいう⊃ゆあ▣	ノイウ⌺ユア◈
similar	えろ⊂	エロ⌹
guide	⊂けのろ	⌹ケノロ
experience	にせは⊊けし	ニセハ⍁ケシ
score	くえきなむ▣	クエキナム◈
apple	⊈⊄すゆさあよ	⌿⌻スユサアヨ
bought	は⊄よ⊊	ハ⌻ヨ⍁
led	⊅⊍むはま	⌼⍕ムハマ
pitch	と▣ら⊂	ト◈ラ⌹
coat	⊍⊌ういさ⊌な⊈	⍕⍢ウイサ⍢ナ⌿
mass	▣まうちう	◈マウチウ
card	あ⊍⊅れ⊋ひの	ア⍕⌼レ⍂ヒノ
band	⊊っらえって	⍁ッラエッテ
rope	▣⊌え▣⊀⊉	◈⍢エ◈⌶⍀
slip	お⊇ほかこり	オ⌾ホカコリ
win	めみゔめりこ⊂け	メミヴメリコ⌹ケ
dream	そてかおふよ	ソテカオフヨ
evening	ち⊈ら⊊ま	チ⌿ラ⍁マ
condition	ゔまあ	ヴマア
feed	わあ▣	ワア◈
tool	⊃⊃のわえけよろ	⌺⌺ノワエケヨロ
total	てのも	テノモ
basic	とにう	トニウ
smell	め⊃⊂お	メ⌺⌹オ
valley	っのへひめ⊃	ッノヘヒメ⌺
nor	ことよ	コトヨ
double	ひ⊊の⊊も	ヒ⍁ノ⍁モ
seat	ゆ⊀へゔめうむにの	ユ⌶ヘヴメウムニノ
arrive	ての▣の⊆	テノ◈ノ⌽
master	けすあくにさ	ケスアクニサ
track	ほそなこは⊆	ホソナコハ⌽
parent	れれ▣ち⊌も	レレ◈チ⍢モ
shore	みひいす⊁み	ミヒイス⌸ミ
division	んさ⊌ゔ⊂	ンサ⍢ヴ⌹
sheet	ふのひ⊍	フノヒ⍕
substance	はやれ⊁ひあ	ハヤレ⌸ヒア
favor	さきせ	サキセ
connect	け⊍まむ	ケ⍕マム
post	ていのわそ	テイノワソ
spend	⊄ろっゆゆ⊁りう⊍	⌻ロッユユ⌸リウ⍕
chord	れのし⊃む⊂	レノシ⌺ム⌹
fat	る⊀⊌えもゆ⊋⊅	ル⌶⍢エモユ⍂⌼
glad	⊁んろ⊌け⊅	⌸ンロ⍢ケ⌼
original	あ⊋にき	ア⍂ニキ
share	ほふ⊁めけた	ホフ⌸メケタ
station	たいむ⊆ゆた	タイム⌽ユタ
dad	まうもえ⊆	マウモエ⌽
bread	ゔえれ⊄ろれけ	ヴエレ⌻ロレケ
charge	たきみ	タキミ
proper	⊍は▣んお	⍕ハ◈ンオ
bar	たは⊆か⊊な⊅い	タハ⌽カ⍁ナ⌼イ
offer	⊋よ⊉ら	⍂ヨ⍀ラ
segment	けけに	ケケニ
slave	へ⊉み⊍う	ヘ⍀ミ⍕ウ
duck	⊉めまるの	⍀メマルノ
instant	のにま⊍い	ノニマ⍕イ
market	ゆまにおひ	ユマニオヒ
degree	みた⊊⊇え	ミタ⍁⌾エ
populate	か⊄さ	カ⌻サ
chick	⊀くよいおおむか	⌶クヨイオオムカ
dear	にっ⊇るけり⊄ひ	ニッ⌾ルケリ⌻ヒ
enemy	おまんむ⊆⊇なの	オマンム⌽⌾ナノ
reply	えかの⊊やっせ⊃	エカノ⍁ヤッセ⌺
drink	しおさへんんと⊋⊅	シオサヘンント⍂⌼
occur	た⊃のけせ	タ⌺ノケセ
support	んた⊊け	ンタ⍁ケ
speech	っらもしと	ッラモシト
nature	⊌れら⊇ゔせ	⍢レラ⌾ヴセ
range	⊀も⊁⊀にき	⌶モ⌸⌶ニキ
steam	さそむる	サソムル
motion	さち⊄にけ⊀	サチ⌻ニケ⌶
path	よてたらわ⊄▣ろめ	ヨテタラワ⌻◈ロメ
liquid	⊇⊂に	⌾⌹ニ
log	ふゆうしめけけ	フユウシメケケ
meant	さるの⊆	サルノ⌽
quotient	にむ⊅	ニム⌼
teeth	ちすと⊊も⊇⊂へ⊃	チスト⍁モ⌾⌹ヘ⌺
shell	⊍かきはるす	⍕カキハルス
neck	みる⊍⊉	ミル⍕⍀
citrus	ゆ⊈や⊁⊌え	ユ⌿ヤ⌸⍢エ
mandarin	⊌んの⊀⊉のけは	⍢ンノ⌶⍀ノケハ
pomelo	⊌み⊀こ⊇てゔ	⍢ミ⌶コ⌾テヴ
citron	いとて	イトテ
micrantha	ほひみこ	ホヒミコ
Ichang papeda	なゆけろさたよちす	ナユケロサタヨチス
kumquat	へえほものさ	ヘエホモノサ
trifoliate orange	お⊅ら⊊き	オ⌼ラ⍁キ
round lime	けせめあゆかみ⊃ん	ケセメアユカミ⌺ン
desert lime	しはせそみ⊍ま	シハセソミ⍕マ
finger lime	は⊁えゆおりちく	ハ⌸エユオリチク
glome	⊅そら⊃▣てその	⌼ソラ⌺◈テソノ
gongyl	きう⊁にたくにと	キウ⌸ニタクニト
tesseract	のす⊄せ	ノス⌻セ
pentachoron	⊋ちか⊀かわゆさ	⍂チカ⌶カワユサ
hexadecachoron	ん⊉なれちう⊊	ン⍀ナレチウ⍁
icositetrachoron	⊋むものしも⊅⊅	⍂ムモノシモ⌼⌼
hecatonicosachoron	るとめ⊈	ルトメ⌿
hexacosichoron	しりよおふうてよ⊁	シリヨオフウテヨ⌸
truncated	いゔないおっみ	イヴナイオッミ
rectified	う⊌ふくおろへふ	ウ⍢フクオロヘフ
cantellated	うくやへふ⊂る⊅か	ウクヤヘフ⌹ル⌼カ
runcinated	け⊂の	ケ⌹ノ
cantitruncated	▣もやてへはか⊂や	◈モヤテヘハカ⌹ヤ
runcitruncated	⊅⊋はへ⊂	⌼⍂ハヘ⌹
runcicantellated	うそ⊊	ウソ⍁
omnitruncated	⊌そゔみた	⍢ソヴミタ
spheritorus	みこう	ミコウ
torisphere	⊉ちけてひめきた	⍀チケテヒメキタ
tiger	ゔみあ	ヴミア
ditorus	のにゆなろこしこ	ノニユナロコシコ
dimension	⊁ろにの⊋のした⊆	⌸ロニノ⍂ノシタ⌽
future	はか⊋かくゆしゔ	ハカ⍂カクユシヴ
Axis A	にえめ⊌さけ⊅よ⊆	ニエメ⍢サケ⌼ヨ⌽
Axis B	たけ⊉ろちあ	タケ⍀ロチア
Axis C	あえけりむゆ	アエケリムユ
Axis D	⊁すせも⊇っ	⌸スセモ⌾ッ
hiragana	にりめひしそ	ニリメヒシソ
katakana	さめま	サメマ
syllabary	なえにに⊉まへ⊍	ナエニニ⍀マヘ⍕
syllable	わひにすっこ	ワヒニスッコ
timbre	ゔしい⊊い⊀らお	ヴシイ⍁イ⌶ラオ
guttural	せ⊌⊂けわへこかの	セ⍢⌹ケワヘコカノ
discrete	いきのる	イキノル
matrix	なんいうほき	ナンイウホキ
modal voice (in contrast to breathy/creaky)	てへのち	テヘノチ
breathy voice	おう⊁	オウ⌸
creaky voice	⊅⊃⊉	⌼⌺⍀
modal voice (in contrast to nasal)	⊁むち⊉りかりこの	⌸ムチ⍀リカリコノ
nasal voice	め⊉⊃あ⊀れ	メ⍀⌺ア⌶レ
Krighteng	ゆたよふいり	ユタヨフイリ
Troteng	⊇らとんくくさ	⌾ラトンククサ
Hotejeng	こ⊁⊉すちっ⊄⊉み	コ⌸⍀スチッ⌻⍀ミ
Dastemme	めや⊌⊈め	メヤ⍢⌿メ
Desentemme	け⊈あと	ケ⌿アト
Duturemme	はっしとおっもた	ハッシトオッモタ
Tevvelnipe	⊂しな	⌹シナ
Desselnipe	⊅⊂へせるとりま	⌼⌹ヘセルトリマ
Zuttelnipe	めおろて⊊そ⊆	メオロテ⍁ソ⌽
Past - Krighteng - Dastemme - Tevvelnipe	⊈⊊⊄ろにお	⌿⍁⌻ロニオ
Past - Krighteng - Dastemme - Gesselnipe	りさい	リサイ
Past - Krighteng - Dastemme - Zuttelnipe	た⊍るは⊉よにお	タ⍕ルハ⍀ヨニオ
Past - Krighteng - Desentemme - Tevvelnipe	ろれせへな	ロレセヘナ
Past - Krighteng - Desentemme - Gesselnipe	てあすのよあうきろ	テアスノヨアウキロ
Past - Krighteng - Desentemme - Zuttelnipe	ゆてへんとのひせし	ユテヘントノヒセシ
Past - Krighteng - Duturemme - Tevvelnipe	っこれすは▣⊁	ッコレスハ◈⌸
Past - Krighteng - Duturemme - Gesselnipe	⊃⊋ちも⊁	⌺⍂チモ⌸
Past - Krighteng - Duturemme - Zuttelnipe	⊀やれ⊉そ	⌶ヤレ⍀ソ
Past - Troteng - Dastemme - Tevvelnipe	のもゔ⊋	ノモヴ⍂
Past - Troteng - Dastemme - Gesselnipe	⊅ま⊂あ⊌らしお	⌼マ⌹ア⍢ラシオ
Past - Troteng - Dastemme - Zuttelnipe	⊅⊌あるらも⊆ん	⌼⍢アルラモ⌽ン
Past - Troteng - Desentemme - Tevvelnipe	めなけ⊅⊀かうは⊌	メナケ⌼⌶カウハ⍢
Past - Troteng - Desentemme - Gesselnipe	く⊁ふろにれ⊀	ク⌸フロニレ⌶
Past - Troteng - Desentemme - Zuttelnipe	のん⊈	ノン⌿
Past - Troteng - Duturemme - Tevvelnipe	⊀⊊む	⌶⍁ム
Past - Troteng - Duturemme - Gesselnipe	らほも⊄いに	ラホモ⌻イニ
Past - Troteng - Duturemme - Zuttelnipe	まらおえんやなり	マラオエンヤナリ
Past - Hotejeng - Dastemme - Tevvelnipe	⊌⊅のふま	⍢⌼ノフマ
Past - Hotejeng - Dastemme - Gesselnipe	⊁⊅なむうと	⌸⌼ナムウト
Past - Hotejeng - Dastemme - Zuttelnipe	▣⊄みわ	◈⌻ミワ
Past - Hotejeng - Desentemme - Tevvelnipe	へ⊀うけ⊅	ヘ⌶ウケ⌼
Past - Hotejeng - Desentemme - Gesselnipe	⊀くら	⌶クラ
Past - Hotejeng - Desentemme - Zuttelnipe	⊈にそせ⊅⊊	⌿ニソセ⌼⍁
Past - Hotejeng - Duturemme - Tevvelnipe	くちふふ	クチフフ
Past - Hotejeng - Duturemme - Gesselnipe	さゔゔ⊋やれふう	サヴヴ⍂ヤレフウ
Past - Hotejeng - Duturemme - Zuttelnipe	⊅めるにいゆ	⌼メルニイユ
Present - Krighteng - Dastemme - Tevvelnipe	へ⊆よ⊍のてに⊍	ヘ⌽ヨ⍕ノテニ⍕
Present - Krighteng - Dastemme - Gesselnipe	めそのめ⊃⊉や	メソノメ⌺⍀ヤ
Present - Krighteng - Dastemme - Zuttelnipe	らし⊀わ⊀な	ラシ⌶ワ⌶ナ
Present - Krighteng - Desentemme - Tevvelnipe	やくけうゆいれち	ヤクケウユイレチ
Present - Krighteng - Desentemme - Gesselnipe	⊅あかみきふ	⌼アカミキフ
Present - Krighteng - Desentemme - Zuttelnipe	ら⊍ま	ラ⍕マ
Present - Krighteng - Duturemme - Tevvelnipe	ふしわにんろく	フシワニンロク
Present - Krighteng - Duturemme - Gesselnipe	え⊍⊇らてし	エ⍕⌾ラテシ
Present - Krighteng - Duturemme - Zuttelnipe	⊃さ⊆⊀わけの⊍ゔ	⌺サ⌽⌶ワケノ⍕ヴ
Present - Troteng - Dastemme - Tevvelnipe	さはめは	サハメハ
Present - Troteng - Dastemme - Gesselnipe	⊍のく	⍕ノク
Present - Troteng - Dastemme - Zuttelnipe	こんや⊆め⊋も▣	コンヤ⌽メ⍂モ◈
Present - Troteng - Desentemme - Tevvelnipe	れあふみんもす⊆く	レアフミンモス⌽ク
Present - Troteng - Desentemme - Gesselnipe	えにににのるん	エニニニノルン
Present - Troteng - Desentemme - Zuttelnipe	⊊かんへかゔとみ	⍁カンヘカヴトミ
Present - Troteng - Duturemme - Tevvelnipe	むと⊇ませひ	ムト⌾マセヒ
Present - Troteng - Duturemme - Gesselnipe	いも⊌えういはき	イモ⍢エウイハキ
Present - Troteng - Duturemme - Zuttelnipe	ひえの⊌お⊂⊅	ヒエノ⍢オ⌹⌼
Present - Hotejeng - Dastemme - Tevvelnipe	なゔほ⊃ほんの	ナヴホ⌺ホンノ
Present - Hotejeng - Dastemme - Gesselnipe	うへけれえと	ウヘケレエト
Present - Hotejeng - Dastemme - Zuttelnipe	⊃あめふ▣⊆⊈	⌺アメフ◈⌽⌿
Present - Hotejeng - Desentemme - Tevvelnipe	すふあ	スフア
Present - Hotejeng - Desentemme - Gesselnipe	りのかれそ	リノカレソ
Present - Hotejeng - Desentemme - Zuttelnipe	る⊂⊅いいお	ル⌹⌼イイオ
Present - Hotejeng - Duturemme - Tevvelnipe	ふ⊌⊁に⊂け	フ⍢⌸ニ⌹ケ
Present - Hotejeng - Duturemme - Gesselnipe	⊉▣⊊め⊍ちてゔ	⍀◈⍁メ⍕チテヴ
Present - Hotejeng - Duturemme - Zuttelnipe	め⊃たきお	メ⌺タキオ
Future - Krighteng - Dastemme - Tevvelnipe	あは⊋さ⊍うほん	アハ⍂サ⍕ウホン
Future - Krighteng - Dastemme - Gesselnipe	こはえやとむ	コハエヤトム
Future - Krighteng - Dastemme - Zuttelnipe	⊍そてに	⍕ソテニ
Future - Krighteng - Desentemme - Tevvelnipe	⊅まい	⌼マイ
Future - Krighteng - Desentemme - Gesselnipe	はもなふのっ⊈⊉⊅	ハモナフノッ⌿⍀⌼
Future - Krighteng - Desentemme - Zuttelnipe	⊍めようまたけり	⍕メヨウマタケリ
Future - Krighteng - Duturemme - Tevvelnipe	⊁まにるろのうせ	⌸マニルロノウセ
Future - Krighteng - Duturemme - Gesselnipe	っあ⊅	ッア⌼
Future - Krighteng - Duturemme - Zuttelnipe	くんにうう	クンニウウ
Future - Troteng - Dastemme - Tevvelnipe	お⊄⊆▣▣ゔ⊄う	オ⌻⌽◈◈ヴ⌻ウ
Future - Troteng - Dastemme - Gesselnipe	さ⊆かにはろせせろ	サ⌽カニハロセセロ
Future - Troteng - Dastemme - Zuttelnipe	ゔゆすえ	ヴユスエ
Future - Troteng - Desentemme - Tevvelnipe	なふこくよむ	ナフコクヨム
Future - Troteng - Desentemme - Gesselnipe	ほとや⊃っらて⊂	ホトヤ⌺ッラテ⌹
Future - Troteng - Desentemme - Zuttelnipe	⊆⊅⊀まてお	⌽⌼⌶マテオ
Future - Troteng - Duturemme - Tevvelnipe	⊄ゔにれ	⌻ヴニレ
Future - Troteng - Duturemme - Gesselnipe	てん⊊ほこく⊂⊉あ	テン⍁ホコク⌹⍀ア
Future - Troteng - Duturemme - Zuttelnipe	あ⊂たわ	ア⌹タワ
Future - Hotejeng - Dastemme - Tevvelnipe	けくにと⊁▣のいあ	ケクニト⌸◈ノイア
Future - Hotejeng - Dastemme - Gesselnipe	ひすゆけ⊃ふふ⊁	ヒスユケ⌺フフ⌸
Future - Hotejeng - Dastemme - Zuttelnipe	にしやとみのり	ニシヤトミノリ
Future - Hotejeng - Desentemme - Tevvelnipe	ゔくやわ⊉	ヴクヤワ⍀
Future - Hotejeng - Desentemme - Gesselnipe	⊄ひれのゔに	⌻ヒレノヴニ
Future - Hotejeng - Desentemme - Zuttelnipe	ろいめ▣か	ロイメ◈カ
Future - Hotejeng - Duturemme - Tevvelnipe	⊂くれい⊃そて	⌹クレイ⌺ソテ
Future - Hotejeng - Duturemme - Gesselnipe	け⊍そ⊍	ケ⍕ソ⍕
Future - Hotejeng - Duturemme - Zuttelnipe	へろ⊉すもくゆてい	ヘロ⍀スモクユテイ
Past - Krighteng - Dastemme - Tevvelnipe (verb tense suffix)	やわにと⊊⊆⊀⊄▣	ヤワニト⍁⌽⌶⌻◈
Past - Krighteng - Dastemme - Gesselnipe (verb tense suffix)	えれよ⊇ほに	エレヨ⌾ホニ
Past - Krighteng - Dastemme - Zuttelnipe (verb tense suffix)	のこ⊉⊄に	ノコ⍀⌻ニ
Past - Krighteng - Desentemme - Tevvelnipe (verb tense suffix)	▣ゆ⊁	◈ユ⌸
Past - Krighteng - Desentemme - Gesselnipe (verb tense suffix)	のあ⊆ほろさ	ノア⌽ホロサ
Past - Krighteng - Desentemme - Zuttelnipe (verb tense suffix)	ま⊄わならなく	マ⌻ワナラナク
Past - Krighteng - Duturemme - Tevvelnipe (verb tense suffix)	るひらまわもてへ	ルヒラマワモテヘ
Past - Krighteng - Duturemme - Gesselnipe (verb tense suffix)	か⊍ら⊄んにおわ	カ⍕ラ⌻ンニオワ
Past - Krighteng - Duturemme - Zuttelnipe (verb tense suffix)	らさ⊃す	ラサ⌺ス
Past - Troteng - Dastemme - Tevvelnipe (verb tense suffix)	⊄⊃⊊と	⌻⌺⍁ト
Past - Troteng - Dastemme - Gesselnipe (verb tense suffix)	け⊄の	ケ⌻ノ
Past - Troteng - Dastemme - Zuttelnipe (verb tense suffix)	こいっへのなもむ	コイッヘノナモム
Past - Troteng - Desentemme - Tevvelnipe (verb tense suffix)	む⊀き⊅	ム⌶キ⌼
Past - Troteng - Desentemme - Gesselnipe (verb tense suffix)	⊉⊇⊃きもせ	⍀⌾⌺キモセ
Past - Troteng - Desentemme - Zuttelnipe (verb tense suffix)	⊈ふおさ⊅	⌿フオサ⌼
Past - Troteng - Duturemme - Tevvelnipe (verb tense suffix)	⊀こきよるき	⌶コキヨルキ
Past - Troteng - Duturemme - Gesselnipe (verb tense suffix)	こる⊋え⊁たっ	コル⍂エ⌸タッ
Past - Troteng - Duturemme - Zuttelnipe (verb tense suffix)	⊋の⊃っよひお	⍂ノ⌺ッヨヒオ
Past - Hotejeng - Dastemme - Tevvelnipe (verb tense suffix)	ほまも⊋むもあ	ホマモ⍂ムモア
Past - Hotejeng - Dastemme - Gesselnipe (verb tense suffix)	けゔ⊄み	ケヴ⌻ミ
Past - Hotejeng - Dastemme - Zuttelnipe (verb tense suffix)	おたもちよ⊂るちっ	オタモチヨ⌹ルチッ
Past - Hotejeng - Desentemme - Tevvelnipe (verb tense suffix)	かにほとくえろ	カニホトクエロ
Past - Hotejeng - Desentemme - Gesselnipe (verb tense suffix)	たよわた⊇のたの	タヨワタ⌾ノタノ
Past - Hotejeng - Desentemme - Zuttelnipe (verb tense suffix)	ふそひむ⊆	フソヒム⌽
Past - Hotejeng - Duturemme - Tevvelnipe (verb tense suffix)	た⊍す	タ⍕ス
Past - Hotejeng - Duturemme - Gesselnipe (verb tense suffix)	えきさ⊌か⊊きまお	エキサ⍢カ⍁キマオ
Past - Hotejeng - Duturemme - Zuttelnipe (verb tense suffix)	かかるはっすふ	カカルハッスフ
Present - Krighteng - Dastemme - Tevvelnipe (verb tense suffix)	ひゔすりとのゆの	ヒヴスリトノユノ
Present - Krighteng - Dastemme - Gesselnipe (verb tense suffix)	わなな	ワナナ
Present - Krighteng - Dastemme - Zuttelnipe (verb tense suffix)	⊊ほへふの	⍁ホヘフノ
Present - Krighteng - Desentemme - Tevvelnipe (verb tense suffix)	なゆな	ナユナ
Present - Krighteng - Desentemme - Gesselnipe (verb tense suffix)	⊀ちする⊊	⌶チスル⍁
Present - Krighteng - Desentemme - Zuttelnipe (verb tense suffix)	⊉▣た	⍀◈タ
Present - Krighteng - Duturemme - Tevvelnipe (verb tense suffix)	ちくいふみ	チクイフミ
Present - Krighteng - Duturemme - Gesselnipe (verb tense suffix)	お⊅⊊やんおわす	オ⌼⍁ヤンオワス
Present - Krighteng - Duturemme - Zuttelnipe (verb tense suffix)	⊊あるひらせとち	⍁アルヒラセトチ
Present - Troteng - Dastemme - Tevvelnipe (verb tense suffix)	きとく	キトク
Present - Troteng - Dastemme - Gesselnipe (verb tense suffix)	▣て⊉⊇せ⊉て	◈テ⍀⌾セ⍀テ
Present - Troteng - Dastemme - Zuttelnipe (verb tense suffix)	ひ⊆⊃⊄っち	ヒ⌽⌺⌻ッチ
Present - Troteng - Desentemme - Tevvelnipe (verb tense suffix)	⊆⊉さかそ⊂⊂	⌽⍀サカソ⌹⌹
Present - Troteng - Desentemme - Gesselnipe (verb tense suffix)	⊈ふ⊈⊃	⌿フ⌿⌺
Present - Troteng - Desentemme - Zuttelnipe (verb tense suffix)	⊅と⊅いゆり	⌼ト⌼イユリ
Present - Troteng - Duturemme - Tevvelnipe (verb tense suffix)	はにそ⊄むはに⊂	ハニソ⌻ムハニ⌹
Present - Troteng - Duturemme - Gesselnipe (verb tense suffix)	ちよ⊁て⊀ほ⊇	チヨ⌸テ⌶ホ⌾
Present - Troteng - Duturemme - Zuttelnipe (verb tense suffix)	る⊅た	ル⌼タ
Present - Hotejeng - Dastemme - Tevvelnipe (verb tense suffix)	⊁く⊉りっき⊃やお	⌸ク⍀リッキ⌺ヤオ
Present - Hotejeng - Dastemme - Gesselnipe (verb tense suffix)	らすし⊄	ラスシ⌻
Present - Hotejeng - Dastemme - Zuttelnipe (verb tense suffix)	⊊けに⊋らのほめ	⍁ケニ⍂ラノホメ
Present - Hotejeng - Desentemme - Tevvelnipe (verb tense suffix)	なろや▣へ	ナロヤ◈ヘ
Present - Hotejeng - Desentemme - Gesselnipe (verb tense suffix)	まろちなおさあお	マロチナオサアオ
Present - Hotejeng - Desentemme - Zuttelnipe (verb tense suffix)	えせ▣えせは	エセ◈エセハ
Present - Hotejeng - Duturemme - Tevvelnipe (verb tense suffix)	へろや⊈そ	ヘロヤ⌿ソ
Present - Hotejeng - Duturemme - Gesselnipe (verb tense suffix)	⊂⊌は⊉っくのゔ	⌹⍢ハ⍀ックノヴ
Present - Hotejeng - Duturemme - Zuttelnipe (verb tense suffix)	▣もう▣ゔ⊌お	◈モウ◈ヴ⍢オ
Future - Krighteng - Dastemme - Tevvelnipe (verb tense suffix)	し⊄に⊂っほの	シ⌻ニ⌹ッホノ
Future - Krighteng - Dastemme - Gesselnipe (verb tense suffix)	⊇めいれそまと	⌾メイレソマト
Future - Krighteng - Dastemme - Zuttelnipe (verb tense suffix)	りふうもてけ⊌	リフウモテケ⍢
Future - Krighteng - Desentemme - Tevvelnipe (verb tense suffix)	ゔま⊊⊊⊆	ヴマ⍁⍁⌽
Future - Krighteng - Desentemme - Gesselnipe (verb tense suffix)	⊄ち⊌る	⌻チ⍢ル
Future - Krighteng - Desentemme - Zuttelnipe (verb tense suffix)	にらけのらに	ニラケノラニ
Future - Krighteng - Duturemme - Tevvelnipe (verb tense suffix)	にい⊍ほみ⊇ろや	ニイ⍕ホミ⌾ロヤ
Future - Krighteng - Duturemme - Gesselnipe (verb tense suffix)	みおし⊃ち⊆ほ⊋	ミオシ⌺チ⌽ホ⍂
Future - Krighteng - Duturemme - Zuttelnipe (verb tense suffix)	⊉▣す⊋ち	⍀◈ス⍂チ
Future - Troteng - Dastemme - Tevvelnipe (verb tense suffix)	⊂のにめ	⌹ノニメ
Future - Troteng - Dastemme - Gesselnipe (verb tense suffix)	くにくさ	クニクサ
Future - Troteng - Dastemme - Zuttelnipe (verb tense suffix)	の⊀そ▣	ノ⌶ソ◈
Future - Troteng - Desentemme - Tevvelnipe (verb tense suffix)	⊋す⊈ろりよ	⍂ス⌿ロリヨ
Future - Troteng - Desentemme - Gesselnipe (verb tense suffix)	⊁▣ち⊈もっあっ	⌸◈チ⌿モッアッ
Future - Troteng - Desentemme - Zuttelnipe (verb tense suffix)	いにきにし⊃⊊ち	イニキニシ⌺⍁チ
Future - Troteng - Duturemme - Tevvelnipe (verb tense suffix)	けれ⊍▣⊁せ⊍な	ケレ⍕◈⌸セ⍕ナ
Future - Troteng - Duturemme - Gesselnipe (verb tense suffix)	へさむたえそへも	ヘサムタエソヘモ
Future - Troteng - Duturemme - Zuttelnipe (verb tense suffix)	⊀す⊊と	⌶ス⍁ト
Future - Hotejeng - Dastemme - Tevvelnipe (verb tense suffix)	や⊉けうっく⊋たな	ヤ⍀ケウック⍂タナ
Future - Hotejeng - Dastemme - Gesselnipe (verb tense suffix)	く⊅こきゆ	ク⌼コキユ
Future - Hotejeng - Dastemme - Zuttelnipe (verb tense suffix)	むりや	ムリヤ
Future - Hotejeng - Desentemme - Tevvelnipe (verb tense suffix)	ろか⊁めはま⊆	ロカ⌸メハマ⌽
Future - Hotejeng - Desentemme - Gesselnipe (verb tense suffix)	⊆⊃あ▣せりけ	⌽⌺ア◈セリケ
Future - Hotejeng - Desentemme - Zuttelnipe (verb tense suffix)	⊂お⊉はひ	⌹オ⍀ハヒ
Future - Hotejeng - Duturemme - Tevvelnipe (verb tense suffix)	⊀きあちろ	⌶キアチロ
Future - Hotejeng - Duturemme - Gesselnipe (verb tense suffix)	に⊊⊉にてめろ	ニ⍁⍀ニテメロ
Future - Hotejeng - Duturemme - Zuttelnipe (verb tense suffix)	ろん⊆	ロン⌽
